1111111111111111111111111111111111
1E0000000000000C00000C000000000001
1010010100100P0010100100000001N101
1010010010101010001001000N00010101
100000000C00C000000000000000N000C1
1111111111111111111111111111111111