11111111111
1P000000001
11101111101
1C00N111C01
10101111101
1C101111101
101C111C001
1C000001E11
11111111111