11111111
1000E001
10000011
100001C1
1P000011
11111111