11111
10001
10001
1C001
100E1
11111