111111
1E00C1
100111
10C0P1
101111
1000E1
111111