111111111
100001E11
100000111
1P0000C11
111111111