11111111
100C0001
1000E001
10P00001
11111111