11111111
1000P011
10000001
1C100P11
11111111