111111
100001
110001
1P1001
110CE1
111111