111111
100C01
10P001
1P0E01
111111