1111111111111
1C010000C00C1
1000011111C01
1P011E0000001
1111111111111