1111111111111
1C000000C00C1
111011C111101
1C0011C111C01
11101100C1101
1C00111111C01
1110111111101
1P00E00000001
1111111111111